{
	"level":
	{
		"name":3,
		"description":2,
		"version":1,
		"author":"Namide"
	},
	
	"tiles":
	[
		{ "id":0, "type":"empty" },
		{ "id":1, "type":"platform", "dir":"h" },
		{ "id":2, "type":"wall", "dir":"h" },
		{ "id":3, "type":"wall", "dir":"v" },
		{
			"id":4,
			"type":"mobile",
			"dir":"h",
			"datas":
			{
				"type":"platform",
				"moveX":{ "type":"cos", "time":2000, "dist":3 }
			}
		},
		{ "id":9, "type":"spawn" }
	],

    "grid":
	[ 
		[ 0 , 0 , 0 , 0 , 0 , 0 , 0 , 0 , 0 , 0 , 0 , 0 , 0 , 0 , 0 , 0 , 0 ],
		[ 0 , 0 , 0 , 0 , 0 , 0 , 0 , 0 , 0 , 0 , 0 , 0 , 0 , 0 , 0 , 0 , 0 ],
		[ 0 , 0 , 0 , 0 , 0 , 0 , 0 , 0 , 0 , 0 , 0 , 0 , 0 , 0 , 0 , 0 , 0 ],
		[ 0 , 3 , 0 , 0 , 0 , 0 , 0 , 0 , 0 , 0 , 0 , 0 , 0 , 0 , 0 , 0 , 3 ],
		[ 0 , 3 , 0 , 9 , 0 , 0 , 0 , 0 , 0 , 0 , 0 , 0 , 0 , 0 , 0 , 0 , 3 ],
		[ 0 , 3 , 0 , 0 , 0 , 0 , 0 , 0 , 0 , 0 , 0 , 0 , 0 , 0 , 0 , 0 , 3 ],
		[ 0 , 3 , 0 , 0 , 0 , 0 , 4 , 4 , 4 , 0 , 0 , 0 , 0 , 0 , 0 , 0 , 3 ],
		[ 0 , 3 , 0 , 0 , 0 , 0 , 0 , 0 , 0 , 0 , 0 , 0 , 0 , 0 , 0 , 0 , 3 ],
		[ 0 , 3 , 0 , 0 , 0 , 0 , 0 , 0 , 0 , 0 , 0 , 0 , 0 , 0 , 0 , 0 , 3 ],
		[ 0 , 3 , 0 , 0 , 0 , 0 , 0 , 0 , 0 , 0 , 0 , 1 , 0 , 0 , 0 , 0 , 3 ],
		[ 0 , 3 , 0 , 0 , 0 , 0 , 0 , 0 , 0 , 1 , 0 , 0 , 0 , 0 , 0 , 0 , 3 ],
		[ 0 , 3 , 0 , 0 , 0 , 0 , 0 , 1 , 0 , 0 , 0 , 0 , 0 , 0 , 0 , 0 , 3 ],
		[ 0 , 3 , 0 , 0 , 0 , 0 , 0 , 0 , 0 , 0 , 0 , 0 , 0 , 0 , 0 , 0 , 3 ],
		[ 0 , 3 , 2 , 2 , 2 , 2 , 2 , 2 , 2 , 2 , 2 , 2 , 2 , 2 , 2 , 2 , 3 ]
	]
}